NO ./path_to_the_north_texture    cccc 
NO EA

WE path_to_the_west_textureEA./path_to_the_east_texture




SO ./path_to_the_south_texture
EA ./path_to_the_east_texture


C 225,30,0

F 220,100,0 C 111,30,0

						111111111
11111111111111111111111111111111
11111110000000000000000000000011
11111111111111111111111111111111

