NO ./path_to_the_north_texture
WE ./path_to_the_west_texture
SO ./path_to_the_south_texture
EA ./path_to_the_east_texture

C 225,30,0
F 220,100,0

        1111111111111111111111111
        1000000000110000000000001
        1011000001110000000000001  11111
        1001000000000000000000001  11001
111111111011000001110000000000001  11111
100000000011000001110111111111111
11110111111111011100000010001
11110111111111011101010010001
11000000110101011100000010001
100000000000000011000E0010001
10000000000000001101010010001
1100000111010101111101111000111
11110111 1110101 101111010001
11111111 1111111 111111111111

// Except for the map, each type of information from an element can be separated
by one or more spaces.

// The map must be parsed as it looks in the file. Spaces are a valid part of the
map and are up to you to handle. You must be able to parse any kind of map,
as long as it respects the rules of the map