NO ./path_to_the_north_texture    cccc
WE ./path_to_the_west_textureEA./path_to_the_east_texture
SO ./path_to_the_south_texture
EA ./path_to_the_east_texture


C 225,30,0
F 220,100,0

       111111111
11111111111111111111111111111111
11111110000000000000000000000011
111111110011111111111110011111111111
111100000000N11100000000000000000001
   111111111111111111111111111111111
                1111